1111111111111
1000000000001
10P0000000001
1000000000001
10000000C0001
1000000000001
1000000000001
100C000100001
1000001100001
1000001C00001
1000000000001
1000000000001
100C000000001
1000111000001
10000E0000001
1000000000001
10C0000000001
10000000C0001
1111111111111