1111111111111111111111111111111111111111111111111
100000C00000000000000000000000000000000000000C001
1000000000000000000000000000000000000000000000001
1000000000000001111111111100000000000000000000001
100C00000000000000000000000000000000C000000000001
1000000000000000000000000000000100000000000000001
1000000000000000000000000000000100000000000000001
100000000E0000000000000C0000000100000000000000001
1000000000000000000000000000000100000000000000001
1P0000000000000000000000000000000000000000000C001
1111111111111111111111111111111111111111111111111
