1111111111111111111
1C0000C0000000C0001
1000C00000000000001
1000000000000000001
1000000000000000001
1000000000000000001
100000000PECCCC0001
1000000000000000001
1000000C00000000001
1000000C00000000001
1111111111111111111
